1 2    2 -2    4 -4
2 2    21 -4    21 -2
3 2    2 21    4 21
4 2    2 -1    4 -3
5 2    21 -3    21 -1
6 2    1 -2    3 -4
7 2    1 21    3 21
8 2    1 -1    3 -3
9 2    -4 4    -2 2
10 2    21 2    21 4
11 2    -4 21    -2 21
12 2    -4 3    -2 1
13 2    21 1    21 3
14 2    -3 4    -1 2
15 2    -3 21    -1 21
16 2    -3 3    -1 1
17 2    1 2    3 4
18 2    2 2    4 4
19 4    -4 2    -3 2    -2 4    -1 4
20 4    1 4    2 4    3 2    4 2
21 1    21 21
22 4    -3 2    -3 4    -1 2    -1 4
23 4    1 2    1 4    3 2    3 4
24 2    -4 2    -2 4
25 2    2 4    4 2
26 2    1 1    3 3
27 4    -4 1    -4 3    -2 1    -2 3
28 4    2 1    2 3    4 1    4 3
29 2    -3 1    -1 3
30 2    1 3    3 1
31 2    2 1    4 3
32 4    -4 1    -3 1    -2 3    -1 3
33 4    1 3    2 3    3 1    4 1
34 4    -3 -4    -3 -2    -1 -4    -1 -2
35 4    1 -4    1 -2    3 -4    3 -2
36 2    -4 -4    -2 -2
37 2    -4 -2    -2 -4
38 2    2 -4    4 -2
39 2    -3 -4    -1 -2
40 4    -4 -2    -3 -2    -2 -4    -1 -4
41 4    1 -4    2 -4    3 -2    4 -2
42 2    -3 -3    -1 -1
43 2    -4 -3    -2 -1
44 4    -4 -1    -3 -1    -2 -3    -1 -3
45 4    1 -3    2 -3    3 -1    4 -1
46 4    -4 -3    -4 -1    -2 -3    -2 -1
47 4    2 -3    2 -1    4 -3    4 -1
48 2    -3 -1    -1 -3
49 2    1 -3    3 -1
50 4    2 -4    2 -3    4 -2    4 -1
51 4    2 3    2 4    4 1    4 2
52 4    1 -4    1 -3    3 -2    3 -1
53 4    1 3    1 4    3 1    3 2
54 4    -4 -2    -4 -1    -2 -4    -2 -3
55 4    -4 1    -4 2    -2 3    -2 4
56 4    -3 -2    -3 -1    -1 -4    -1 -3
57 4    -3 1    -3 2    -1 3    -1 4
